#BP1 Chr,BP1 Start,BP1 End,BP2 Chr,BP2 Start,BP2 End,Supp.,Size (bp)
chr1,1219982,1223434,chr1,1225577,1229105,,2143
chr1,9591985,9595341,chr1,9597227,9600089,,1886
chr1,14432636,14436290,chr1,14437570,14441375,,1280
chr1,25154228,25158676,chr1,25161514,25165093,,2838
chr1,26456898,26459838,chr1,26463789,26468542,,3951
chr1,34985513,34991181,chr1,34992539,34996862,,1358
chr1,56827433,56831099,chr1,56834909,56838758,,3810
chr1,63702441,63705334,chr1,63708226,63712091,,2892
chr1,71234176,71237339,chr1,71239506,71243649,,2167
chr1,73450444,73454045,chr1,73454999,73458655,,954
chr1,81400468,81404472,chr1,81408850,81413863,,4378
chr1,83465559,83469370,chr1,83477194,83482174,,7824
chr1,84513313,84517907,chr1,84524680,84528485,,6773
chr1,84708940,84711986,chr1,84715625,84719559,,3639
chr1,97657769,97660911,chr1,97669287,97672164,,8376
chr1,106011959,106016763,chr1,106023133,106026856,,6370
chr1,107217125,107222220,chr1,107223107,107229248,,887
chr1,108730241,108733240,chr1,108737139,108741157,,3899
chr1,110183007,110188076,chr1,110190877,110195347,,2801
chr1,113215882,113221119,chr1,113224360,113228986,,3241
chr1,116224845,116229439,chr1,116232523,116237054,,3084
chr1,145087506,145093102,chr1,145096826,145101547,,3724
chr1,158862935,158867476,chr1,158869332,158873313,,1856
chr1,179325893,179330458,chr1,179332696,179337887,,2238
chr1,179450982,179455462,chr1,179457941,179461858,,2479
chr1,184810138,184814613,chr1,184820856,184824172,,6243
chr1,197496174,197500497,chr1,197503019,197506713,,2522
chr1,206196105,206201100,chr1,206204558,206209774,,3458
chr1,207538358,207541947,chr1,207544901,207549865,,2954
chr1,210073183,210076156,chr1,210083759,210086702,,7603
chr1,229808620,229812448,chr1,229820888,229823967,,8440
chr1,232454490,232458021,chr1,232459720,232463478,,1699
chr1,238479704,238483552,chr1,238485664,238489584,,2112
chr1,248048061,248051468,chr1,248057471,248061344,,6003
chr2,1097647,1101967,chr2,1104548,1107542,,2581
chr2,1214589,1218811,chr2,1227052,1231902,,8241
chr2,1341926,1346043,chr2,1348762,1351743,,2719
chr2,4777856,4781284,chr2,4787289,4790798,,6005
chr2,11391361,11394666,chr2,11399696,11403933,,5030
chr2,16267901,16271547,chr2,16274058,16278112,,2511
chr2,33088738,33091602,chr2,33095837,33098992,,4235
chr2,36212682,36216149,chr2,36219159,36222182,,3010
chr2,40761679,40764780,chr2,40772187,40776152,,7407
chr2,76522203,76526482,chr2,76528580,76533319,,2098
chr2,79072942,79076298,chr2,79080535,79084314,,4237
chr2,79329560,79332427,chr2,79340085,79343563,,7658
chr2,89024107,89029186,chr2,89032250,89036680,,3064
chr2,106876453,106879315,chr2,106885950,106888812,,6635
chr2,107895379,107899331,chr2,107902985,107907350,,3654
chr2,108272240,108275202,chr2,108278766,108282045,,3564
chr2,119649907,119653243,chr2,119659341,119663593,,6098
chr2,126439903,126442995,chr2,126451374,126455168,,8379
chr2,130432522,130437800,chr2,130444772,130449065,,6972
chr2,130545696,130549556,chr2,130558302,130562716,,8746
chr2,134962174,134966692,chr2,134969953,134975262,,3261
chr2,159955084,159959408,chr2,159961184,159964933,,1776
chr2,162329257,162332119,chr2,162334457,162337434,,2338
chr2,170636358,170640750,chr2,170643778,170646698,,3028
chr2,177262743,177265605,chr2,177272587,177275449,,6982
chr2,202142972,202146622,chr2,202149209,202152734,,2587
chr2,209939026,209943299,chr2,209948576,209951775,,5277
chr2,217085890,217089914,chr2,217092137,217096117,,2223
chr2,220048764,220052266,chr2,220056195,220059926,,3929
chr2,223756860,223760158,chr2,223762503,223766340,,2345
chr2,227160464,227165399,chr2,227171059,227173971,,5660
chr2,232393348,232397193,chr2,232400141,232403838,,2948
chr2,235551147,235554212,chr2,235557680,235560808,,3468
chr2,238447706,238451483,chr2,238453865,238457095,,2382
chr2,242741860,242744722,chr2,242748878,242751740,,4156
chr3,4062722,4066883,chr3,4069516,4072897,,2633
chr3,17537316,17540852,chr3,17545150,17548889,,4298
chr3,22088622,22092324,chr3,22097412,22101461,,5088
chr3,25969591,25973347,chr3,25978418,25982836,,5071
chr3,26436264,26439477,chr3,26445541,26449165,,6064
chr3,42834857,42838188,chr3,42840278,42844399,,2090
chr3,58531873,58534735,chr3,58537295,58540157,,2560
chr3,67490793,67493658,chr3,67496840,67499988,,3182
chr3,83849460,83853088,chr3,83855293,83858701,,2205
chr3,93665268,93669340,chr3,93670413,93673763,,1073
chr3,98896090,98898968,chr3,98902468,98905388,,3500
chr3,98940888,98943750,chr3,98949179,98952041,,5429
chr3,107034093,107037882,chr3,107040259,107043431,,2377
chr3,120157900,120161334,chr3,120164909,120168300,,3575
chr3,128669066,128672057,chr3,128674484,128678337,,2427
chr3,129072955,129075817,chr3,129082766,129085628,,6949
chr3,130344301,130347557,chr3,130353005,130356623,,5448
chr3,136016782,136020961,chr3,136025873,136029914,,4912
chr3,146380894,146385163,chr3,146390166,146395114,,5003
chr3,160720549,160723432,chr3,160724021,160728820,,589
chr3,162760638,162764845,chr3,162769155,162773222,,4310
chr3,163655020,163658805,chr3,163664987,163669216,,6182
chr3,177290212,177294442,chr3,177297279,177300567,,2837
chr3,186577626,186581002,chr3,186585067,186588403,,4065
chr3,187729174,187732036,chr3,187734734,187737784,,2698
chr3,192871950,192875296,chr3,192885136,192890631,,9840
chr3,194395510,194398372,chr3,194400805,194403802,,2433
chr4,3609034,3615017,chr4,3618599,3622303,,3582
chr4,10388516,10392404,chr4,10401988,10404957,,9584
chr4,16941202,16945672,chr4,16950703,16954250,,5031
chr4,19075217,19079377,chr4,19085506,19089076,,6129
chr4,21155964,21160900,chr4,21166624,21170601,,5724
chr4,42758944,42762416,chr4,42769284,42772785,,6868
chr4,59941173,59944496,chr4,59950359,59953869,,5863
chr4,61325715,61331232,chr4,61333288,61337393,,2056
chr4,73549356,73552218,chr4,73561379,73564878,,9161
chr4,79266181,79269090,chr4,79275358,79278638,,6268
chr4,80883345,80888023,chr4,80893952,80897541,,5929
chr4,83698257,83701956,chr4,83704282,83708226,,2326
chr4,88479734,88483755,chr4,88486261,88490292,,2506
chr4,91593326,91596775,chr4,91602687,91606898,,5912
chr4,94555083,94560418,chr4,94565089,94568899,,4671
chr4,108124800,108127787,chr4,108131477,108135185,,3690
chr4,115171374,115174662,chr4,115182912,115186293,,8250
chr4,115924550,115928682,chr4,115931788,115935113,,3106
chr4,119122241,119125371,chr4,119129611,119134289,,4240
chr4,130062111,130065916,chr4,130068324,130071292,,2408
chr4,135429353,135433008,chr4,135435646,135438845,,2638
chr4,163389791,163392653,chr4,163395118,163397980,,2465
chr4,165999409,166002454,chr4,166004638,166008852,,2184
chr4,171174890,171177752,chr4,171180241,171183103,,2489
chr4,172370862,172374373,chr4,172379378,172383665,,5005
chr4,172984775,172989093,chr4,172992341,172995638,,3248
chr4,174529208,174532070,chr4,174535491,174538353,,3421
chr4,184652174,184655728,chr4,184657947,184661728,,2219
chr4,186437444,186441598,chr4,186443309,186447300,,1711
chr4,187090227,187093089,chr4,187097953,187101137,,4864
chr4,188342968,188345863,chr4,188347481,188351509,,1618
chr4,190053655,190057911,chr4,190063600,190066849,,5689
chr4,190601603,190606920,chr4,190610201,190614584,,3281
chr5,1964353,1968378,chr5,1971566,1977522,,3188
chr5,12808034,12810896,chr5,12820756,12824573,,9860
chr5,18452208,18456085,chr5,18459830,18464834,,3745
chr5,18868972,18873112,chr5,18874750,18879547,,1638
chr5,21606857,21611796,chr5,21614749,21619556,,2953
chr5,24366970,24370519,chr5,24373378,24376908,,2859
chr5,29706095,29709904,chr5,29711508,29715584,,1604
chr5,34300578,34304708,chr5,34307834,34311977,,3126
chr5,57676480,57679976,chr5,57686094,57690155,,6118
chr5,59944841,59947703,chr5,59952238,59955100,,4535
chr5,61804524,61807544,chr5,61810268,61813744,,2724
chr5,63695220,63698297,chr5,63701125,63704390,,2828
chr5,83944725,83947913,chr5,83955395,83959656,,7482
chr5,103850608,103854256,chr5,103860183,103864439,,5927
chr5,108591764,108595067,chr5,108601043,108604636,,5976
chr5,114322312,114325286,chr5,114335069,114338724,,9783
chr5,120645717,120649524,chr5,120651986,120656240,,2462
chr5,132914272,132918941,chr5,132924153,132928517,,5212
chr5,136850836,136855041,chr5,136856214,136859445,,1173
chr5,147549442,147552304,chr5,147554462,147557580,,2158
chr5,151451430,151456401,chr5,151461965,151467110,,5564
chr5,174126397,174129667,chr5,174132180,174135042,,2513
chr5,176383400,176387450,chr5,176390002,176393920,,2552
chr5,177818326,177821621,chr5,177823817,177827476,,2196
chr6,19761376,19765096,chr6,19770947,19774217,,5851
chr6,29681178,29685415,chr6,29688062,29691865,,2647
chr6,33934874,33937783,chr6,33942660,33946136,,4877
chr6,54658958,54662425,chr6,54665884,54668746,,3459
chr6,56755301,56758261,chr6,56760886,56764618,,2625
chr6,57281043,57286376,chr6,57289240,57299261,,2864
chr6,57417631,57423054,chr6,57428871,57434459,,5817
chr6,70010354,70014091,chr6,70018028,70023018,,3937
chr6,81622752,81625911,chr6,81630504,81633366,,4593
chr6,85314645,85318086,chr6,85323815,85327744,,5729
chr6,94536687,94539866,chr6,94544939,94548748,,5073
chr6,110473032,110476699,chr6,110479698,110484106,,2999
chr6,112221307,112224184,chr6,112229905,112233885,,5721
chr6,119161560,119165019,chr6,119172467,119176620,,7448
chr6,125704314,125708707,chr6,125711004,125714486,,2297
chr6,126179223,126183221,chr6,126187093,126191334,,3872
chr6,129315217,129319424,chr6,129325491,129328684,,6067
chr6,133337915,133341795,chr6,133347710,133350963,,5915
chr6,153026313,153029695,chr6,153033276,153036638,,3581
chr6,153954736,153957939,chr6,153960993,153964090,,3054
chr6,164540432,164543306,chr6,164547190,164551036,,3884
chr6,165720010,165724618,chr6,165732147,165737402,,7529
chr7,4412772,4416537,chr7,4419798,4423386,,3261
chr7,25053948,25057329,chr7,25059883,25064862,,2554
chr7,32386359,32390021,chr7,32392974,32397656,,2953
chr7,49716462,49719822,chr7,49725861,49730062,,6039
chr7,51591196,51594222,chr7,51598615,51601577,,4393
chr7,55283365,55286622,chr7,55288797,55292643,,2175
chr7,64311223,64315743,chr7,64317818,64321662,,2075
chr7,73824236,73828408,chr7,73830500,73834295,,2092
chr7,82702779,82705905,chr7,82709158,82712806,,3253
chr7,84154057,84156919,chr7,84157308,84160170,,389
chr7,93413023,93416917,chr7,93422950,93427712,,6033
chr7,96472104,96475869,chr7,96481971,96486191,,6102
chr7,100998223,101001128,chr7,101003833,101007745,,2705
chr7,110177718,110181937,chr7,110186691,110191834,,4754
chr7,113413233,113416122,chr7,113422237,113425982,,6115
chr7,118827732,118831226,chr7,118834735,118838701,,3509
chr7,126041620,126045845,chr7,126050534,126054644,,4689
chr7,129296863,129299725,chr7,129302048,129305743,,2323
chr7,148069310,148072808,chr7,148076022,148079779,,3214
chr7,158497185,158500690,chr7,158504533,158508133,,3843
chr8,590749,594379,chr8,599355,603532,,4976
chr8,960050,963586,chr8,967640,971642,,4054
chr8,11489120,11492924,chr8,11495214,11498329,,2290
chr8,16197004,16201246,chr8,16207422,16211454,,6176
chr8,25063428,25068680,chr8,25069734,25073623,,1054
chr8,37385095,37389594,chr8,37395165,37399765,,5571
chr8,40771502,40774384,chr8,40779321,40782398,,4937
chr8,42187032,42190226,chr8,42194190,42197389,,3964
chr8,63031034,63034929,chr8,63040195,63044278,,5266
chr8,68153164,68156524,chr8,68161879,68165119,,5355
chr8,72211728,72216132,chr8,72217805,72221536,,1673
chr8,73784191,73787709,chr8,73793865,73797618,,6156
chr8,96871796,96875167,chr8,96879800,96882884,,4633
chr8,124868793,124871757,chr8,124877828,124881223,,6071
chr8,126590077,126595099,chr8,126601036,126604775,,5937
chr8,129460647,129465135,chr8,129471211,129475398,,6076
chr8,130136975,130140897,chr8,130145096,130149468,,4199
chr8,131197197,131201216,chr8,131210164,131214235,,8948
chr8,135079988,135082868,chr8,135088694,135092827,,5826
chr8,137155470,137160159,chr8,137163801,137166868,,3642
chr8,140252931,140256694,chr8,140258784,140261842,,2090
chr8,144631089,144633951,chr8,144636568,144639430,,2617
chr9,11206454,11210588,chr9,11215783,11220964,,5195
chr9,12553691,12556788,chr9,12559609,12563421,,2821
chr9,71735066,71738808,chr9,71743435,71747247,,4627
chr9,78915817,78919396,chr9,78921842,78925556,,2446
chr9,84320336,84324318,chr9,84326926,84329880,,2608
chr9,110030144,110033227,chr9,110035423,110039462,,2196
chr9,110533733,110537352,chr9,110540349,110544682,,2997
chr9,110655176,110658038,chr9,110662636,110665975,,4598
chr9,130029812,130033075,chr9,130035087,130038732,,2012
chr9,130178578,130181748,chr9,130186149,130189179,,4401
chr9,138210732,138214044,chr9,138217637,138223194,,3593
chr9,140249678,140253150,chr9,140255891,140260453,,2741
chr9,140769763,140774831,chr9,140776787,140781361,,1956
chr10,1738044,1740906,chr10,1743233,1746095,,2327
chr10,5886388,5889250,chr10,5892561,5895423,,3311
chr10,6407764,6411429,chr10,6417250,6420683,,5821
chr10,26995815,26998677,chr10,27002113,27004975,,3436
chr10,38789414,38795054,chr10,38795690,38798552,,636
chr10,39120715,39123577,chr10,39126206,39129068,,2629
chr10,42527061,42531930,chr10,42532103,42536455,,173
chr10,54012016,54015508,chr10,54017817,54021852,,2309
chr10,55079052,55082142,chr10,55090229,55093495,,8087
chr10,94131212,94134575,chr10,94137687,94140596,,3112
chr10,99031606,99034833,chr10,99036936,99041673,,2103
chr10,102351438,102354381,chr10,102361681,102365007,,7300
chr10,106101204,106105530,chr10,106106748,106110569,,1218
chr10,111568568,111572041,chr10,111578149,111581553,,6108
chr10,114109068,114113550,chr10,114116185,114120321,,2635
chr10,132985112,132988406,chr10,132990664,132994838,,2258
chr10,134945906,134948856,chr10,134952221,134955205,,3365
chr10,135287172,135290042,chr10,135292769,135296621,,2727
chr11,1651318,1654180,chr11,1656419,1659775,,2239
chr11,3235138,3239843,chr11,3243981,3248044,,4138
chr11,4963794,4969340,chr11,4975118,4980155,,5778
chr11,5870561,5873812,chr11,5883130,5886408,,9318
chr11,29003653,29007043,chr11,29012492,29015900,,5449
chr11,45189321,45193409,chr11,45197529,45202241,,4120
chr11,47948075,47952718,chr11,47961833,47967336,,9115
chr11,48363049,48367484,chr11,48373427,48376696,,5943
chr11,48597949,48600818,chr11,48603687,48607581,,2869
chr11,60683731,60688496,chr11,60696165,60700201,,7669
chr11,60847945,60851764,chr11,60852973,60857721,,1209
chr11,61940706,61943860,chr11,61953525,61956387,,9665
chr11,62386981,62390413,chr11,62391975,62395874,,1562
chr11,65930191,65933592,chr11,65939273,65942184,,5681
chr11,90564121,90567866,chr11,90570955,90574529,,3089
chr11,90754571,90758723,chr11,90762388,90766313,,3665
chr11,92866072,92869774,chr11,92875728,92879344,,5954
chr11,105289901,105293446,chr11,105298911,105302354,,5465
chr11,114421196,114424162,chr11,114430417,114435034,,6255
chr12,14210042,14213704,chr12,14216250,14219286,,2546
chr12,31948887,31951749,chr12,31954578,31957440,,2829
chr12,40895986,40899172,chr12,40905755,40908617,,6583
chr12,42694320,42697494,chr12,42699407,42703523,,1913
chr12,43973586,43977274,chr12,43979425,43982846,,2151
chr12,53372356,53375563,chr12,53377667,53382430,,2104
chr12,60749838,60753056,chr12,60757766,60761357,,4710
chr12,70590726,70594709,chr12,70597310,70601286,,2601
chr12,80154645,80157975,chr12,80159284,80163038,,1309
chr12,96230306,96233568,chr12,96236300,96239956,,2732
chr12,96335769,96340325,chr12,96342567,96346494,,2242
chr12,125096520,125100077,chr12,125103553,125107106,,3476
chr12,130336701,130339565,chr12,130342896,130345811,,3331
chr13,32529212,32532511,chr13,32538401,32541263,,5890
chr13,51066023,51069000,chr13,51074302,51077570,,5302
chr13,66890009,66893486,chr13,66898191,66902976,,4705
chr13,67332822,67335994,chr13,67341384,67345605,,5390
chr13,70121550,70127032,chr13,70127746,70131942,,714
chr13,72804623,72807485,chr13,72812415,72815277,,4930
chr13,93005230,93009159,chr13,93018571,93022150,,9412
chr13,113258980,113263099,chr13,113267897,113271835,,4798
chr13,114846089,114848975,chr13,114852049,114855115,,3074
chr14,23090931,23094822,chr14,23098199,23101877,,3377
chr14,28865638,28868500,chr14,28871065,28873927,,2565
chr14,35300560,35304095,chr14,35306749,35310016,,2654
chr14,40605658,40609724,chr14,40617207,40621353,,7483
chr14,45145804,45150241,chr14,45150983,45153845,,742
chr14,65356215,65360233,chr14,65362928,65366678,,2695
chr14,85293392,85296483,chr14,85300974,85304137,,4491
chr14,107082421,107089780,chr14,107096156,107101361,,6376
chr15,22333139,22336731,chr15,22343873,22346735,,7142
chr15,55215033,55218012,chr15,55224187,55227360,,6175
chr15,65811756,65815996,chr15,65818685,65822402,,2689
chr15,68421997,68425988,chr15,68428866,68432392,,2878
chr15,71018514,71021790,chr15,71027370,71030916,,5580
chr15,72382675,72385927,chr15,72388119,72391177,,2192
chr15,72568386,72571753,chr15,72575386,72579157,,3633
chr15,82392972,82396611,chr15,82401629,82404932,,5018
chr15,86052677,86056986,chr15,86058863,86062283,,1877
chr15,89481083,89483945,chr15,89486536,89489398,,2591
chr15,98529175,98532455,chr15,98536201,98540010,,3746
chr15,101091519,101096432,chr15,101098048,101102625,,1616
chr16,2577003,2581082,chr16,2583485,2587100,,2403
chr16,5423016,5426814,chr16,5428971,5432575,,2157
chr16,16930590,16934353,chr16,16940338,16944506,,5985
chr16,18829325,18833363,chr16,18838259,18842053,,4896
chr16,25336572,25340082,chr16,25342763,25345812,,2681
chr17,133109,136632,chr17,137505,141889,,873
chr17,1638040,1642119,chr17,1644324,1647840,,2205
chr17,15784780,15789905,chr17,15793225,15796747,,3320
chr17,21209111,21212881,chr17,21221154,21224956,,8273
chr17,25532745,25536493,chr17,25540200,25543062,,3707
chr17,41433726,41437789,chr17,41439183,41443554,,1394
chr17,61987062,61991907,chr17,61992175,61996921,,268
chr17,74358659,74362597,chr17,74364647,74368977,,2050
chr17,74783545,74786407,chr17,74790556,74793418,,4149
chr17,77988865,77991991,chr17,78000543,78004820,,8552
chr18,18511313,18514175,chr18,18514606,18520184,,431
chr18,23744557,23747743,chr18,23751607,23755400,,3864
chr18,28766762,28771283,chr18,28775833,28778985,,4550
chr18,47691169,47694933,chr18,47696990,47702476,,2057
chr18,49192416,49196558,chr18,49198912,49202473,,2354
chr18,51949005,51952873,chr18,51956960,51960826,,4087
chr18,63330779,63334307,chr18,63340253,63343151,,5946
chr18,63632474,63635437,chr18,63640109,63644928,,4672
chr18,63763561,63766790,chr18,63768932,63772464,,2142
chr18,65384504,65389148,chr18,65395773,65399696,,6625
chr18,76126587,76129723,chr18,76132332,76135376,,2609
chr18,77306394,77309838,chr18,77312090,77315980,,2252
chr19,6854816,6858402,chr19,6861194,6864665,,2792
chr19,10610090,10612952,chr19,10619988,10622850,,7036
chr19,12604002,12606896,chr19,12611359,12614251,,4463
chr19,16100072,16103130,chr19,16106143,16109481,,3013
chr19,29946128,29950164,chr19,29955441,29959454,,5277
chr19,30384161,30388736,chr19,30393054,30396813,,4318
chr19,36954780,36957661,chr19,36960301,36963428,,2640
chr19,51327437,51330388,chr19,51333808,51337493,,3420
chr19,53685399,53689152,chr19,53691864,53696139,,2712
chr19,54552136,54554998,chr19,54561022,54563884,,6024
chr20,2800125,2803124,chr20,2806433,2810270,,3309
chr20,7092919,7096580,chr20,7102260,7105990,,5680
chr20,13813627,13817220,chr20,13822767,13825693,,5547
chr20,32812906,32815842,chr20,32819269,32822254,,3427
chr20,42267303,42271498,chr20,42273921,42277745,,2423
chr20,54430683,54434533,chr20,54440590,54444187,,6057
chr20,55100447,55103457,chr20,55105825,55108797,,2368
chr21,11086192,11089780,chr21,11092602,11096079,,2822
chr21,22001696,22005523,chr21,22010528,22013668,,5005
chr21,26859173,26862280,chr21,26865644,26869506,,3364
chr21,44967071,44970317,chr21,44972908,44977498,,2591
chr22,18053950,18057628,chr22,18060280,18064827,,2652
chr22,24191796,24195520,chr22,24197910,24200982,,2390
chr22,36568300,36571774,chr22,36575439,36579177,,3665
chr22,37140005,37143031,chr22,37147941,37151550,,4910
chrX,1752882,1755750,chrX,1760166,1763577,,4416
chrX,2191898,2195084,chrX,2200086,2203381,,5002
chrX,10524701,10528605,chrX,10530743,10534521,,2138
chrX,11720569,11725339,chrX,11731046,11734365,,5707
chrX,26359541,26363107,chrX,26366052,26369692,,2945
chrX,32983817,32986679,chrX,32988932,32992432,,2253
chrX,38580371,38584330,chrX,38587444,38591335,,3114
chrX,43941575,43944781,chrX,43947196,43950879,,2415
chrX,70133984,70137078,chrX,70139934,70143743,,2856
chrX,81092002,81096623,chrX,81101754,81106339,,5131
chrX,85601335,85604868,chrX,85609650,85613695,,4782
chrX,92792544,92796248,chrX,92801304,92805182,,5056
chrX,118870544,118873929,chrX,118876324,118880223,,2395
chrX,140473801,140476676,chrX,140479553,140483125,,2877
chrX,144418334,144422010,chrX,144424420,144428180,,2410
chrX,150704050,150706972,chrX,150712230,150715382,,5258
